10 15
2 2
1 1 1 1 4 3 4 1 1 1
1 0 0 0 0 0 0 0 0 1
1 0 0 9 0 0 8 0 0 1
1 0 0 0 0 0 0 0 0 1
1 0 5 11 1 0 4 0 0 1
1 0 0 0 0 0 0 0 0 1
1 0 1 9 3 0 3 0 3 1
1 0 0 0 0 0 0 0 0 1
1 0 1 9 1 0 0 9 0 1
1 0 1 0 1 0 0 0 0 2
3 0 10 0 10 0 0 0 0 3
1 0 2 0 1 0 0 0 0 1
1 0 0 0 0 0 0 0 0 1
1 0 0 0 0 0 0 0 0 1
1 1 1 1 1 1 1 1 1 1
